twitter_handle_id,degree_total,degree_in,degree_out,pr,adj_tri
1.00052e+18,3,2,1,4.020357891282577e-4,0
1.00259e+18,1,0,1,2.0060070574787447e-4,0
1.00355e+18,2,1,1,0.0013373380383133726,0
1.0046e+18,5,4,1,0.003180861424325574,0
1.00476e+18,2,1,1,0.0013373380383133726,0
1.00492e+18,4,1,3,2.347028257250131e-4,0.5
1.00542e+18,2,1,1,3.391054740411646e-4,0
1.00612e+18,6,2,4,0.00038982284674682186,0.2
1.00616e+18,4,2,2,0.0010152521776448467,0
1.00754e+18,3,2,1,0.0023323212610800743,0
1.00852e+18,4,2,2,7.945256933544648e-4,0
1.00931e+18,11,3,8,6.067841600666126e-4,0.01818181818181818
1.01046e+18,2,1,1,0.0013373380383133726,0
1.01114e+18,5,3,2,4.4808415684120475e-4,0
1.01202e+18,3,2,1,4.7889243742521527e-4,0
1.013e+18,11,6,5,0.0020241961705358582,0.16363636363636364
101317272,3,1,2,2.788436707902331e-4,0
1.01622e+18,3,2,1,5.687758027904007e-4,0
1.01639e+18,8,5,3,7.111418803103007e-4,0.2857142857142857
1.01775e+18,5,1,4,3.0016250761843457e-4,0
1.01936e+18,4,1,3,3.434522683799729e-4,0
1.02031e+18,2,0,2,2.0060070574787447e-4,0
1.02139e+18,2,1,1,0.0013373380383133726,0
1.02151e+18,4,1,3,3.314282696196136e-4,0
1.02235e+18,2,1,1,4.245944497404046e-4,0
1.0234e+18,4,3,1,0.0037803405712897218,0
1.02553e+18,2,1,1,4.47524079358464e-4,0
102700779,3,1,2,5.809961732020259e-4,0
1.02866e+18,4,3,1,2.8652315225516324e-4,0
1.03005e+18,9,5,4,6.968247487917738e-4,0.1111111111111111
1.03138e+18,6,5,1,9.017821363485032e-4,0.13333333333333333
1.03165e+18,10,3,7,7.715968276917136e-4,0
1.03204e+18,2,1,1,0.0013373380383133726,0
1.03259e+18,6,2,4,7.424399638514753e-4,0.06666666666666667
1.03407e+18,3,2,1,5.940613350222723e-4,0
1.03542e+18,13,6,7,9.082244446242789e-4,0.07692307692307693
1.03545e+18,3,2,1,5.091981483048053e-4,0
1.03627e+18,1,0,1,2.0060070574787447e-4,0
1.03985e+18,1,0,1,2.0060070574787447e-4,0
104119607,2,1,1,0.0013373380383133726,0
1.04243e+18,9,8,1,0.0012652692219037862,0.1111111111111111
1.04331e+18,17,12,5,0.001259507718829574,0.15441176470588236
1.04824e+18,2,1,1,2.8585600569072114e-4,0
104904044,1,0,1,2.0060070574787447e-4,0
1.05113e+18,1,0,1,2.0060070574787447e-4,0
1051409982,3,2,1,0.0035844007912275862,0
1.05182e+18,3,1,2,3.7479335299780324e-4,0
1.05256e+18,4,3,1,0.0010154272794693012,0
1.05267e+18,8,3,5,0.0015662863647296315,0.07142857142857142
1.05487e+18,2,1,1,2.6821959205906816e-4,0
105500699,2,1,1,3.1211005517857725e-4,0
1.05608e+18,6,2,4,4.456137975469247e-4,0
1.05903e+18,4,1,3,2.8974519668454636e-4,0.16666666666666666
1.05986e+18,5,3,2,3.536730164230224e-4,0.1
1.06135e+18,16,7,9,7.056842169084646e-4,0.11666666666666667
1.06145e+18,7,4,3,0.0013897043898180531,0.047619047619047616
1.06164e+18,8,3,5,7.559791906167754e-4,0
1.06216e+18,6,3,3,6.134448167263309e-4,0.13333333333333333
1.06407e+18,2,1,1,3.904016030640915e-4,0
1.06788e+18,21,10,11,0.001434886574673316,0.14285714285714285
1.074e+18,7,4,3,8.578592531197517e-4,0.047619047619047616
1.07404e+18,2,0,2,2.0060070574787447e-4,0
1.07449e+18,3,2,1,0.0019517906505134139,0
1.07551e+18,2,1,1,0.0013373380383133726,0
1.07612e+18,1,0,1,2.0060070574787447e-4,0
1.07841e+18,4,0,4,2.0060070574787447e-4,0
1.07867e+18,2,1,1,5.634252536546521e-4,0
1.07887e+18,5,2,3,6.698855199475314e-4,0
1.07936e+18,22,5,17,7.610837423032399e-4,0
1.08123e+18,4,2,2,9.041411625579216e-4,0.16666666666666666
1.08152e+18,3,2,1,3.115031700641288e-4,0
1.08188e+18,3,0,3,2.0060070574787447e-4,0
1.08303e+18,5,4,1,8.159517608489833e-4,0
1.08342e+18,10,8,2,7.103125403402556e-4,0.15555555555555556
1.08362e+18,2,1,1,0.0013373380383133726,0
1.08428e+18,28,13,15,0.0013807582066336008,0.06084656084656084
1.08429e+18,1,0,1,2.0060070574787447e-4,0
1.08452e+18,11,7,4,6.45893584547267e-4,0.07272727272727272
1084984824,5,4,1,0.0010434323927335655,0
1.08638e+18,10,4,6,7.295310512831919e-4,0.06666666666666667
108878985,1,0,1,2.0060070574787447e-4,0
1.08905e+18,13,9,4,8.305497984986305e-4,0.12820512820512822
1.08921e+18,14,1,13,2.982798134891397e-4,0.010989010989010988
1.09173e+18,14,8,6,0.002625664949138874,0.03296703296703297
1.09426e+18,4,0,4,2.0060070574787447e-4,0
1.09726e+18,2,1,1,0.0013373380383133726,0
1.09844e+18,2,0,2,2.0060070574787447e-4,0
1.10443e+18,2,1,1,0.0011525717754464885,0
1.10554e+18,16,9,7,0.0010696038307005677,0.058333333333333334
110626303,1,0,1,2.0060070574787447e-4,0
1.10839e+18,1,0,1,2.0060070574787447e-4,0
1.10845e+18,1,0,1,2.0060070574787447e-4,0
1.10868e+18,5,1,4,2.5497765282406904e-4,0
1.11016e+18,4,2,2,4.03803834765654e-4,0
1.11096e+18,5,4,1,0.0025726234010256827,0
1.11129e+18,12,6,6,0.001264442761197686,0.22727272727272727
111421712,1,0,1,2.0060070574787447e-4,0
1.11456e+18,1,0,1,2.0060070574787447e-4,0
1.11573e+18,3,2,1,4.2237749193369537e-4,0.3333333333333333
1.11713e+18,3,2,1,3.443279970324339e-4,0
1.11779e+18,4,3,1,4.577081580552164e-4,0
1.11781e+18,6,4,2,0.001143798704725571,0
1.1179e+18,4,3,1,4.723973396572702e-4,0
1.11846e+18,6,4,2,4.4504411007883403e-4,0
1.1203e+18,1,0,1,2.0060070574787447e-4,0
1.1222e+18,13,8,5,8.28912964052514e-4,0.12820512820512822
112256703,1,0,1,2.0060070574787447e-4,0
1.125e+18,2,1,1,2.9684620072492526e-4,0
1.12786e+18,1,0,1,2.0060070574787447e-4,0
1.12803e+18,3,0,3,2.0060070574787447e-4,0
1.13043e+18,4,2,2,3.997996704950297e-4,0
1.1319e+18,6,5,1,0.001195113652759795,0.06666666666666667
1.13221e+18,2,1,1,0.0013373380383123509,0
1.13388e+18,2,1,1,3.598878807719409e-4,0
1.13401e+18,15,10,5,0.0014220830263715995,0.10476190476190475
1.13846e+18,3,2,1,0.0016841686508447403,0
1.13998e+18,7,6,1,6.285699102643821e-4,0.19047619047619047
1.14007e+18,3,2,1,4.6341112857389025e-4,0
1.1411e+18,6,3,3,6.28328234678406e-4,0
1.14146e+18,5,2,3,6.426645863522539e-4,0
1.14153e+18,2,1,1,3.5330791489668475e-4,0
1.1417e+18,10,4,6,7.593151073163483e-4,0.044444444444444446
1.14227e+18,1,0,1,2.0060070574787447e-4,0
1.14301e+18,4,2,2,3.9655440619177805e-4,0
1.1459e+18,4,1,3,2.4081924846723385e-4,0
1.14629e+18,1,0,1,2.0060070574787447e-4,0
1.1485e+18,4,2,2,8.114545159566023e-4,0
1.14989e+18,2,1,1,5.943502828623385e-4,0
1.14997e+18,8,5,3,0.0017185114154482037,0
1.15027e+18,6,3,3,0.001052714721683195,0
1151355734,4,2,2,9.987344023460589e-4,0.16666666666666666
1.15149e+18,11,9,2,8.754866669599974e-4,0.12727272727272726
1.15183e+18,1,0,1,2.0060070574787447e-4,0
115277678,2,1,1,3.293951712424305e-4,0
1.15396e+18,2,1,1,3.434522683799729e-4,0
1.15578e+18,2,1,1,0.0013373380383133726,0
1.15627e+18,2,1,1,4.966641267702499e-4,0
1.15769e+18,41,16,25,0.0016506215482157388,0.05365853658536586
1.15826e+18,12,6,6,7.353110262862118e-4,0.09090909090909091
1.15913e+18,1,0,1,2.0060070574787447e-4,0
1159890631,2,1,1,7.363433295472144e-4,0
1.16108e+18,3,2,1,0.0012466414280314635,0
1.16314e+18,2,1,1,2.4430616892406643e-4,0
116430721,7,2,5,3.2500413152293625e-4,0.19047619047619047
1.16814e+18,2,1,1,0.0013373380383133726,0
1.16986e+18,4,2,2,4.606364681667903e-4,0
1.17064e+18,3,2,1,5.722264228290898e-4,0
1.17138e+18,1,0,1,2.0060070574787447e-4,0
1.17178e+18,10,6,4,0.0014169082474083715,0.022222222222222223
1.17434e+18,2,0,2,2.0060070574787447e-4,0
117550842,13,5,8,8.843553047817168e-4,0.025641025641025644
11774,8,3,5,5.031435483297068e-4,0.03571428571428571
1177439730,2,1,1,6.799123418896557e-4,0
1.17758e+18,7,5,2,8.395035193449092e-4,0.2857142857142857
1.17804e+18,1,0,1,2.0060070574787447e-4,0
1.17828e+18,9,1,8,2.669071094754746e-4,0
1.18027e+18,1,0,1,2.0060070574787447e-4,0
1.18173e+18,1,0,1,2.0060070574787447e-4,0
1.18436e+18,2,1,1,0.0013373380383133726,0
1.1844e+18,27,12,15,0.0011701130069593526,0.031339031339031334
1.18633e+18,10,5,5,5.533508975691411e-4,0.06666666666666667
1.18708e+18,14,10,4,0.0016973831783264677,0.1758241758241758
1.18856e+18,21,13,8,0.0037026417099323278,0.08571428571428572
1.19171e+18,30,15,15,0.0017032014007955852,0.09425287356321839
1.1934e+18,5,3,2,8.490968890614875e-4,0
1.1953e+18,2,1,1,4.6826565366550697e-4,0
1.19766e+18,8,4,4,0.0012186780414178736,0.07142857142857142
1.19881e+18,2,1,1,2.942946062532967e-4,0
1.19899e+18,2,1,1,3.391054740408057e-4,0
1.20141e+18,5,1,4,3.3143591523659565e-4,0
1.20206e+18,11,6,5,8.811809831161352e-4,0.05454545454545454
1.20221e+18,2,1,1,3.0202903521466435e-4,0
1.20278e+18,8,4,4,6.779939879068031e-4,0.17857142857142858
120288669,2,1,1,0.0013373380383133726,0
1.20289e+18,11,3,8,6.452784443686398e-4,0
1.20339e+18,16,7,9,8.105632154838664e-4,0.11666666666666667
1.20364e+18,26,11,15,9.343536464734371e-4,0.10153846153846154
1.20376e+18,20,11,9,0.001331527361328295,0.021052631578947368
1.20451e+18,16,7,9,0.001662461316743115,0.058333333333333334
1.20452e+18,5,1,4,4.52919976364061e-4,0
1.2062e+18,4,2,2,8.537048186042576e-4,0
1.20664e+18,7,4,3,0.001013183177412504,0
1.20779e+18,4,2,2,5.428245115232617e-4,0
1213873928,7,5,2,9.111584847229852e-4,0.14285714285714285
1.21408e+18,5,3,2,4.6640470504300875e-4,0
1.21466e+18,8,4,4,0.0017447083946880452,0.07142857142857142
1.21738e+18,1,0,1,2.0060070574787447e-4,0
1218147452,6,5,1,9.709416819503172e-4,0.4
1.21817e+18,2,0,2,2.0060070574787447e-4,0
1.21828e+18,4,2,2,6.278359855660325e-4,0.16666666666666666
1.21866e+18,2,1,1,4.966641267691576e-4,0
1.21948e+18,2,1,1,0.0013373380383133726,0
1.22231e+18,5,3,2,5.270441035118357e-4,0.2
1.22256e+18,6,3,3,4.298571938998791e-4,0.06666666666666667
122258113,4,1,3,2.650711490055066e-4,0.16666666666666666
1.22281e+18,14,12,2,9.791569931097274e-4,0.3186813186813187
1.22371e+18,9,3,6,4.2980880876029284e-4,0
1.22452e+18,19,6,13,0.0011673648782450387,0.04678362573099415
122520941,4,1,3,2.574375723764389e-4,0
1.22628e+18,18,7,11,7.74747373714972e-4,0.1111111111111111
1.22942e+18,2,1,1,0.0010301117322148066,0
1.22991e+18,1,0,1,2.0060070574787447e-4,0
1.23012e+18,7,3,4,5.099670787638088e-4,0.14285714285714285
1.23069e+18,19,15,4,0.0011980864448776847,0.34502923976608185
1.23117e+18,2,1,1,0.0013373380383133726,0
1.23127e+18,7,3,4,5.451762307062262e-4,0.09523809523809523
1.23293e+18,8,3,5,5.649796407959797e-4,0.10714285714285714
1.23338e+18,1,0,1,2.0060070574787447e-4,0
1.23559e+18,9,4,5,6.067729662078323e-4,0.1111111111111111
1.2362e+18,3,0,3,2.0060070574787447e-4,0
1.23628e+18,6,2,4,4.208222857586695e-4,0.13333333333333333
1.23737e+18,5,2,3,3.447472028788468e-4,0.1
123783243,3,1,2,5.395927278596329e-4,0.3333333333333333
1.23885e+18,1,0,1,2.0060070574787447e-4,0
1.23898e+18,24,15,9,0.00161206961513536,0.17028985507246377
1.23994e+18,1,0,1,2.0060070574787447e-4,0
1.23999e+18,3,2,1,9.744197390235079e-4,0
1.24028e+18,9,4,5,5.568770952057924e-4,0
1.24032e+18,9,3,6,8.205893973491789e-4,0.2777777777777778
1.24129e+18,2,1,1,0.0013373380383123509,0
1.24213e+18,12,6,6,0.0010571566036960123,0.16666666666666666
1.24236e+18,7,1,6,2.443061689240676e-4,0.19047619047619047
1.24322e+18,5,1,4,3.448827176680651e-4,0
1.24387e+18,7,2,5,3.5057103354831304e-4,0
1.24419e+18,2,0,2,2.0060070574787447e-4,0
1.24446e+18,5,3,2,7.284003095668764e-4,0.1
124627569,1,0,1,2.0060070574787447e-4,0
1.24714e+18,5,3,2,0.001271444160582986,0
1.2482e+18,5,4,1,7.819561929220135e-4,0.2
1.24943e+18,5,2,3,6.019597129718051e-4,0.2
1.24965e+18,1,0,1,2.0060070574787447e-4,0
1.24979e+18,4,2,2,3.0114303555263205e-4,0
1.2514e+18,2,0,2,2.0060070574787447e-4,0
1.25257e+18,7,3,4,6.048217185282473e-4,0
1.25321e+18,4,2,2,8.617072881132794e-4,0
1.25399e+18,4,2,2,3.5720733921453554e-4,0.16666666666666666
1.25406e+18,30,13,17,0.0012188832503119674,0.16551724137931034
1.25418e+18,4,1,3,2.2928907060933645e-4,0.5
1.25505e+18,1,0,1,2.0060070574787447e-4,0
1.25623e+18,11,6,5,0.0011020931843624014,0.10909090909090909
1.25842e+18,2,1,1,0.0013373380383133726,0
1.25895e+18,4,2,2,7.312325871890277e-4,0.16666666666666666
1.25923e+18,5,2,3,6.31119929663842e-4,0
1.25937e+18,11,6,5,0.0015529408222599644,0.14545454545454545
1.25948e+18,2,1,1,0.0010967239147441576,0
1.25991e+18,11,6,5,7.719279641979371e-4,0.01818181818181818
1.26004e+18,2,1,1,0.0013373380383133726,0
1.26119e+18,6,4,2,0.002777244499342976,0
1.26211e+18,6,5,1,9.264556360929287e-4,0.06666666666666667
1.26317e+18,6,5,1,0.0021785123661529323,0.06666666666666667
1.26322e+18,15,13,2,0.0017381254191086853,0.2285714285714286
1.26326e+18,1,0,1,2.0060070574787447e-4,0
1.2638e+18,1,0,1,2.0060070574787447e-4,0
1.26454e+18,12,4,8,0.0011187304201427867,0.1212121212121212
1.2646e+18,1,0,1,2.0060070574787447e-4,0
1.26548e+18,4,1,3,4.888403586825593e-4,0
1.26556e+18,20,9,11,8.300006768060636e-4,0.19473684210526318
1.26611e+18,6,5,1,5.259513593047341e-4,0.06666666666666667
1.26622e+18,3,2,1,0.004690165099103989,0
1.26648e+18,38,20,18,0.0031890009141508093,0.112375533428165
1.26705e+18,3,0,3,2.0060070574787447e-4,0
1.26845e+18,2,1,1,3.711113056335678e-4,0
1.26914e+18,5,2,3,3.975950816747411e-4,0.1
1.26977e+18,2,1,1,2.8585600569072114e-4,0
1.27033e+18,11,5,6,0.001229595157058437,0
1.27043e+18,13,6,7,0.0010008987514145556,0.012820512820512822
1.27119e+18,2,1,1,0.0013373380383123509,0
1.27138e+18,2,1,1,0.0018596227586821722,0
1.27243e+18,35,6,29,0.001476060356302728,0.001680672268907563
1.27301e+18,33,20,13,0.002952179407723114,0.08522727272727272
1.2733e+18,13,6,7,6.46710646408084e-4,0.012820512820512822
1.27342e+18,2,1,1,0.0013373380383133726,0
1.27349e+18,1,0,1,2.0060070574787447e-4,0
1.27406e+18,1,0,1,2.0060070574787447e-4,0
1.27424e+18,3,2,1,0.001402243442952803,0
1.27426e+18,6,3,3,8.915760905758393e-4,0.13333333333333333
1.27514e+18,9,4,5,7.696188793457938e-4,0.05555555555555555
1.27794e+18,1,0,1,2.0060070574787447e-4,0
1.27809e+18,8,3,5,8.050742858747432e-4,0.17857142857142858
1.27877e+18,4,3,1,4.2211301322796934e-4,0
1.27947e+18,2,1,1,0.0011763098701054004,0
1.27955e+18,2,0,2,2.0060070574787447e-4,0
1.28002e+18,4,3,1,4.545936863824899e-4,0
128051393,7,3,4,5.837646694407151e-4,0.047619047619047616
1.28056e+18,3,1,2,2.3865489286303498e-4,0
1.28123e+18,3,2,1,3.075464126429685e-4,0
1.28159e+18,14,6,8,7.897148907239645e-4,0.021978021978021976
1.28187e+18,2,0,2,2.0060070574787447e-4,0
1.28245e+18,33,20,13,0.0018216368887862798,0.11363636363636363
1.28342e+18,4,2,2,0.0011543434881875563,0
1.28364e+18,2,0,2,2.0060070574787447e-4,0
1.28392e+18,3,2,1,3.4333783034950436e-4,0
1.28414e+18,3,0,3,2.0060070574787447e-4,0.3333333333333333
1.28436e+18,6,4,2,9.617632157227652e-4,0
1.28574e+18,4,0,4,2.0060070574787447e-4,0.5
1.28713e+18,47,19,28,0.0014840986392112955,0.11100832562442184
1.28776e+18,48,20,28,0.0016424212948356347,0.12322695035460994
1.28828e+18,4,2,2,2.8997988061236303e-4,0
1.2892e+18,14,7,7,9.653028807117353e-4,0.054945054945054944
1.28966e+18,25,8,17,8.822160825761405e-4,0.01
1.28969e+18,6,3,3,3.9560688252561705e-4,0
1.29027e+18,2,0,2,2.0060070574787447e-4,0
1.29037e+18,4,2,2,3.130939198907328e-4,0
1.29056e+18,18,4,14,5.712612987420606e-4,0.0196078431372549
1291076396,9,4,5,9.675928677342651e-4,0
1.29218e+18,11,4,7,9.049909250389282e-4,0.09090909090909091
1.29386e+18,24,13,11,0.001288446847737818,0.18115942028985507
1.29421e+18,23,12,11,0.0012474245697726807,0.2015810276679842
1.29471e+18,26,14,12,0.00119006493280649,0.21846153846153846
1.2952e+18,4,2,2,0.002212933010694905,0
1.29527e+18,2,1,1,0.0013373380383133726,0
1.2956e+18,2,1,1,0.0013373380383133726,0
1.29612e+18,8,3,5,4.858936491707479e-4,0.21428571428571427
1.29677e+18,2,1,1,2.8585600569072114e-4,0
1.29687e+18,5,4,1,8.535926031744452e-4,0
1.30015e+18,4,3,1,5.202299413342775e-4,0.5
1.30172e+18,2,1,1,0.0013373380383133726,0
1.30221e+18,1,0,1,2.0060070574787447e-4,0
1.30232e+18,2,1,1,0.0010301117322132672,0
1.30255e+18,24,11,13,0.001007131776430572,0.21014492753623187
1.30258e+18,28,15,13,0.0013880285001190177,0.14814814814814814
1.30315e+18,2,1,1,0.0013373380383123509,0
1.30337e+18,8,1,7,2.6319557976292016e-4,0.03571428571428571
130384095,15,7,8,0.0014476490130539324,0.019047619047619046
1.30395e+18,3,1,2,3.711113056335678e-4,0
1.30403e+18,2,1,1,2.8407781392521253e-4,0
1.30408e+18,15,7,8,0.0010734000916730027,0.047619047619047616
1.30457e+18,2,1,1,0.0013373380383133726,0
1.30468e+18,4,2,2,0.0019517906505104284,0
1.30473e+18,2,1,1,2.4622796721373647e-4,0
1.30477e+18,12,6,6,5.313038017478835e-4,0.09090909090909091
1.30516e+18,18,3,15,5.457261793180579e-4,0
1.30546e+18,2,1,1,2.986025312065623e-4,0
1.30566e+18,10,0,10,2.0060070574787453e-4,0
1.30574e+18,24,12,12,0.0013274030391095665,0.14492753623188406
1.30622e+18,2,1,1,2.54977652823927e-4,0
1.30681e+18,2,1,1,0.0011410972352915358,0
1.30732e+18,33,15,18,0.001473064902452887,0.06439393939393939
1.30824e+18,46,11,35,0.0016778869025993242,0.028985507246376812
1.30838e+18,14,3,11,5.51395833166101e-4,0.010989010989010988
1.30974e+18,1,0,1,2.0060070574787447e-4,0
1.31061e+18,10,5,5,7.023308782554364e-4,0.1111111111111111
1.31111e+18,22,16,6,0.002283892156632918,0.10389610389610389
1.31158e+18,10,0,10,2.0060070574787453e-4,0
131181656,1,0,1,2.0060070574787447e-4,0
1.31238e+18,3,2,1,3.5103149863953837e-4,1
1.31315e+18,16,6,10,6.831530657024603e-4,0.008333333333333333
1.31357e+18,2,1,1,0.0013373380383133726,0
1.31364e+18,36,12,24,0.0010159150002902514,0.10158730158730159
1.3147e+18,12,7,5,0.00120816981982426,0.0606060606060606
1.31506e+18,3,1,2,4.5441285727345243e-4,0
1.3157e+18,2,1,1,0.0013373380383123509,0
1.31647e+18,3,1,2,4.2810956630436075e-4,0
1.31679e+18,3,2,1,3.6146304757891706e-4,0
1.31745e+18,4,1,3,3.711113056335678e-4,0
1.31759e+18,4,3,1,0.001074234381999964,0
1.31994e+18,3,2,1,3.117629541625638e-4,0
1.32057e+18,2,1,1,0.0013373380383133726,0
132097541,1,0,1,2.0060070574787447e-4,0
1321406095,1,0,1,2.0060070574787447e-4,0
1.32148e+18,2,1,1,0.0013373380383133726,0
1.32279e+18,6,4,2,7.601931336150804e-4,0.06666666666666667
1.32506e+18,3,2,1,0.0015514402178527845,0
1325431674,4,2,2,3.120740558033635e-4,0
1325491398,3,2,1,3.2633061510314897e-4,0
1.32625e+18,8,4,4,0.0011571104488645161,0
1.32646e+18,4,3,1,7.602642757864013e-4,0
1.32667e+18,27,7,20,9.648903242139594e-4,0.07692307692307693
1.32751e+18,1,0,1,2.0060070574787447e-4,0
1.32871e+18,4,2,2,0.0037708869016237303,0
1.32948e+18,20,12,8,0.0028289742333805715,0.04736842105263158
1.32964e+18,4,1,3,4.888403586822004e-4,0
1.32978e+18,3,1,2,2.716393976753212e-4,0.3333333333333333
1.32994e+18,3,2,1,0.001973738238822103,0
1.33066e+18,7,4,3,7.809037116005568e-4,0
1.33109e+18,3,1,2,2.942946062532967e-4,0
1.3315e+18,6,4,2,9.270566836932822e-4,0.26666666666666666
1.33267e+18,2,1,1,0.0013373380383123509,0
1.33345e+18,2,1,1,3.073260354633487e-4,0
1.33403e+18,2,0,2,2.0060070574787447e-4,0
1.33451e+18,12,4,8,0.0010044736914397573,0.1212121212121212
1.33474e+18,3,2,1,4.612801073019214e-4,0
1.33506e+18,9,6,3,6.79225698194372e-4,0.027777777777777776
1.33663e+18,56,28,28,0.0034589719442986526,0.08636363636363636
1.33709e+18,1,0,1,2.0060070574787447e-4,0
1.33786e+18,2,1,1,5.978796871435022e-4,0
1.33791e+18,3,1,2,3.7479335299780324e-4,0
1.33827e+18,6,5,1,0.0013973573925917199,0.33333333333333337
1.33848e+18,31,11,20,0.0010735826227269724,0.16129032258064516
1.34028e+18,1,0,1,2.0060070574787447e-4,0
1.34086e+18,10,5,5,5.166290201121007e-4,0.044444444444444446
1.34102e+18,29,15,14,0.0014682622036686008,0.15024630541871922
1.34253e+18,2,1,1,0.0013373380383123509,0
134285663,4,2,2,6.106031635064143e-4,0
1.34297e+18,11,6,5,0.0013292684356018614,0.07272727272727272
1.34351e+18,6,4,2,0.0012598980328992345,0.13333333333333333
1.34463e+18,3,2,1,7.332340908444628e-4,0.3333333333333333
1.34506e+18,85,34,51,0.003199905121672312,0.021008403361344536
1.34518e+18,3,2,1,4.563666055764144e-4,0
1.34541e+18,9,5,4,8.626231390910215e-4,0.05555555555555555
1.34568e+18,4,2,2,6.744019728863851e-4,0.16666666666666666
1.3468e+18,24,1,23,2.3792502279675471e-4,0.11594202898550723
1.34684e+18,1,0,1,2.0060070574787447e-4,0
1.34722e+18,5,4,1,6.304002348910854e-4,0.1
1.34768e+18,4,3,1,0.002507614744200742,0
1.34779e+18,1,0,1,2.0060070574787447e-4,0
1.34793e+18,4,3,1,3.273144457898335e-4,0
1.34821e+18,4,1,3,3.249902480610909e-4,0.16666666666666666
1.34841e+18,1,0,1,2.0060070574787447e-4,0
1.34909e+18,4,2,2,0.002108525197638313,0
1.34919e+18,5,4,1,4.4728566762723476e-4,0.3
1.34944e+18,7,3,4,8.645831684568225e-4,0.09523809523809523
1350641384,1,0,1,2.0060070574787447e-4,0
1.35171e+18,1,0,1,2.0060070574787447e-4,0
1.35204e+18,6,4,2,0.002295786269079745,0
1.353e+18,7,5,2,0.0012689357261813443,0.047619047619047616
1.35302e+18,6,4,2,5.31211532229225e-4,0
1.35373e+18,29,16,13,0.0018704737785044316,0.11576354679802955
1.35461e+18,9,5,4,0.0010767253246982999,0.08333333333333333
1.35469e+18,7,6,1,0.004980382374260462,0.09523809523809523
1.35475e+18,5,2,3,4.1249719370825826e-4,0.2
1.35492e+18,52,27,25,0.00382803215564964,0.10105580693815988
1.35519e+18,14,8,6,0.0017288961158438304,0.10989010989010989
1.35521e+18,6,3,3,7.329421054794765e-4,0.06666666666666667
1.35531e+18,2,1,1,0.0013373380383123509,0
1.35556e+18,6,2,4,3.887142438557478e-4,0
1.35597e+18,2,1,1,2.7266828745982667e-4,0
1.35653e+18,2,0,2,2.0060070574787447e-4,0
1.35674e+18,8,5,3,6.259561760225528e-4,0.2857142857142857
1.35783e+18,43,15,28,0.001882019213276331,0.10631229235880399
1357980644,2,1,1,0.0013373380383123509,0
1.358e+18,6,0,6,2.0060070574787447e-4,0
1.35803e+18,9,6,3,9.831939422455156e-4,0.027777777777777776
1.35842e+18,16,6,10,0.0011529626524551509,0.14166666666666666
1.35938e+18,15,9,6,0.0016922911058445387,0.09523809523809523
1.3595e+18,2,1,1,3.022984841304698e-4,0
1.35959e+18,18,3,15,3.4098790369599033e-4,0.0196078431372549
1.36e+18,9,7,2,0.0012322382273655965,0.2222222222222222
1.36002e+18,2,0,2,2.0060070574787447e-4,0
1.36017e+18,5,3,2,5.837063081338593e-4,0.2
1.36054e+18,3,2,1,4.861776517131016e-4,0
1.36074e+18,5,4,1,5.345266200831262e-4,0.1
1.36175e+18,5,4,1,0.0020570523755297837,0.1
1.36221e+18,6,2,4,6.610183438825651e-4,0.06666666666666667
1.36237e+18,46,17,29,0.0016123572599618875,0.09371980676328502
1.36292e+18,4,2,2,8.674035245477389e-4,0
1.36393e+18,13,5,8,0.0011561336014594228,0.1794871794871795
1.3657e+18,67,23,44,0.00272111569415912,0.10085933966530981
1.36595e+18,10,2,8,3.8923256306588937e-4,0
1.3664e+18,4,1,3,5.713512396189836e-4,0.3333333333333333
1.36687e+18,14,8,6,0.0011264480039725323,0.14285714285714285
136699524,2,1,1,3.711113056335678e-4,0
1.36722e+18,2,1,1,0.00194909522494596,0
1.36738e+18,9,3,6,3.7886829711586813e-4,0.08333333333333333
1.36778e+18,15,5,10,9.538403741742877e-4,0.028571428571428574
1.36849e+18,4,1,3,2.4195666557361848e-4,0
1.36855e+18,2,1,1,2.8842763916693163e-4,0
1.36875e+18,8,2,6,2.598436124118848e-4,0.07142857142857142
1.36897e+18,5,3,2,7.453067707556992e-4,0.1
1.36929e+18,11,8,3,0.0013268726268145532,0.09090909090909091
1.37004e+18,4,3,1,4.505060664837046e-4,0.3333333333333333
1.37014e+18,3,1,2,3.711113056335678e-4,0
1.37073e+18,11,5,6,0.0014360094360470793,0
1.37109e+18,3,1,2,8.710089147825325e-4,0.3333333333333333
1.37214e+18,5,1,4,2.3741188417289149e-4,0
1.37325e+18,16,5,11,6.887249158835544e-4,0.1
1.37355e+18,8,4,4,6.314254456721342e-4,0.21428571428571427
1373901266,3,2,1,0.00289222876083114,0
1.37416e+18,12,6,6,0.0010519812666525612,0.13636363636363635
1.37475e+18,4,1,3,2.5416192510669235e-4,0
1.37588e+18,28,9,19,8.343082634457118e-4,0.07407407407407407
1.37615e+18,3,1,2,2.6473712168284953e-4,0
1.37699e+18,5,1,4,2.3792502279675471e-4,0.2
1.37752e+18,19,8,11,8.928670752259659e-4,0.11695906432748537
1.37793e+18,4,3,1,4.331764962781424e-4,0
137929020,3,2,1,0.001449674492690666,0
1384411003,14,5,9,0.0015759268790753345,0.054945054945054944
1386211,2,1,1,6.239694530751819e-4,0
1394931644,1,0,1,2.0060070574787447e-4,0
1398734786,2,1,1,3.0722092638776357e-4,0
1402485997,7,5,2,0.001650400920507406,0.047619047619047616
14069156,1,0,1,2.0060070574787447e-4,0
14142759,1,0,1,2.0060070574787447e-4,0
14173396,3,0,3,2.0060070574787447e-4,0
1423877940,2,1,1,4.47524079358464e-4,0
142529439,1,0,1,2.0060070574787447e-4,0
1431264253,6,3,3,9.263427325759009e-4,0
1431474084,2,1,1,4.571500518554018e-4,0
14348298,3,2,1,0.0012895293230929033,0
14441721,1,0,1,2.0060070574787447e-4,0
147523003,1,0,1,2.0060070574787447e-4,0
1498924710,2,1,1,6.475176100269708e-4,0
150159234,2,1,1,2.2010361662985672e-4,0
15033504,1,0,1,2.0060070574787447e-4,0
151106382,1,0,1,2.0060070574787447e-4,0
15177772,2,1,1,4.381898587663531e-4,0
1523167039,2,1,1,0.0013373380383133726,0
152678723,2,1,1,2.50850743149106e-4,0
1531699093,2,1,1,0.0013373380383133726,0
15329909,3,2,1,4.738611058422782e-4,0.3333333333333333
153903226,2,1,1,2.6564937125062954e-4,0
1539126318,2,1,1,2.6319557976292016e-4,0
15404720,7,3,4,3.8892098041043774e-4,0
1540996266,2,1,1,0.0013373380383123509,0
155884105,1,0,1,2.0060070574787447e-4,0
1559043654,4,2,2,3.7997074216593145e-4,0
1567700198,7,6,1,5.72269675842607e-4,0.14285714285714285
157324480,4,2,2,6.141714273508142e-4,0.16666666666666666
157605764,21,4,17,8.741092635238626e-4,0.047619047619047616
157675450,6,2,4,9.730142083886802e-4,0
159954936,4,1,3,2.946250876847225e-4,0
1615886408,5,2,3,3.8399519938508547e-4,0
161964466,1,0,1,2.0060070574787447e-4,0
162502313,7,5,2,0.0015124002520678092,0
1631401460,8,1,7,2.5672183838706513e-4,0
163273990,1,0,1,2.0060070574787447e-4,0
163664036,3,1,2,0.0011136999304463336,0
16435722,1,0,1,2.0060070574787447e-4,0
164595203,9,4,5,9.255656282384114e-4,0.027777777777777776
164998268,2,1,1,0.0016276570015225243,0
1651182841,2,1,1,2.4160854452695915e-4,0
165241607,7,3,4,8.355535194512288e-4,0
16535687,12,4,8,5.891282260241142e-4,0.01515151515151515
16545981,2,1,1,0.0013373380383123509,0
1656936157,4,2,2,3.481932819996054e-4,0.16666666666666666
16725596,3,1,2,2.424525478599924e-4,0
16862817,1,0,1,2.0060070574787447e-4,0
16899180,2,1,1,0.0013373380383133726,0
170516130,6,3,3,6.712151389476206e-4,0
171415738,2,1,1,2.8376776243294695e-4,0
1721981778,2,1,1,4.6306447997657515e-4,0
172983745,6,3,3,8.807278443313078e-4,0.2
173033375,5,3,2,5.557808106743687e-4,0.1
173277360,1,0,1,2.0060070574787447e-4,0
17413138,2,1,1,0.0013373380383123509,0
17532775,12,6,6,9.234886861538934e-4,0
17889256,2,1,1,0.0013373380383133726,0
179656739,3,0,3,2.0060070574787447e-4,0.3333333333333333
179861626,2,1,1,2.3741188417289149e-4,0
18122072,3,0,3,2.0060070574787447e-4,0
18152452,50,23,27,0.003070311681594125,0.09142857142857144
183362434,8,5,3,7.763568535451779e-4,0
184813842,20,4,16,0.0012402211625674845,0.021052631578947368
1867108873,2,1,1,2.2010361662985672e-4,0
1872117943,3,2,1,0.0017627323000693616,0
187294348,4,1,3,3.4345226837994257e-4,0
18761832,6,1,5,2.3470282572501315e-4,0
190109301,2,1,1,3.199969550512823e-4,0
1906372862,5,2,3,8.119530675881451e-4,0.2
191417203,1,0,1,2.0060070574787447e-4,0
192446249,70,20,50,0.0024671618059900905,0.0650103519668737
1928045881,3,1,2,2.4622796721377084e-4,0
19287394,1,0,1,2.0060070574787447e-4,0
193086374,5,3,2,9.079766542220699e-4,0
194499127,6,4,2,7.956399108132078e-4,0
19640334,6,3,3,4.088915947801518e-4,0.2
197714198,4,1,3,4.888403586825593e-4,0
19841658,9,4,5,0.0014674307713774008,0.1111111111111111
20004467,2,0,2,2.0060070574787447e-4,0
20066079,5,4,1,0.001020611543103248,0
202119411,4,2,2,6.297998774533836e-4,0
203480711,4,1,3,2.315251892425478e-4,0
20644666,2,1,1,0.0013373380383133726,0
20912098,3,1,2,2.669071094754746e-4,0
21071552,1,0,1,2.0060070574787447e-4,0
21213803,3,2,1,8.469909184125236e-4,0
21259280,7,4,3,0.0015369230082877081,0.14285714285714285
21326475,2,1,1,3.5836919806631295e-4,0
214342143,3,2,1,6.387487217543869e-4,0
215098522,5,4,1,0.00480520444897358,0.1
21537473,2,1,1,3.576109412179119e-4,0
2162666399,3,1,2,3.023862463307327e-4,0
216877746,16,4,12,5.677911913321323e-4,0.03333333333333333
217035219,1,0,1,2.0060070574787447e-4,0
2172540562,6,3,3,5.820023936835689e-4,0
2173143861,7,4,3,4.082894347969113e-4,0
2191010738,5,4,1,7.27770070351463e-4,0
2198495797,10,4,6,9.091374034909836e-4,0.1111111111111111
2204806447,1,0,1,2.0060070574787447e-4,0
2204965955,1,0,1,2.0060070574787447e-4,0
22054049,1,0,1,2.0060070574787447e-4,0
2206539405,3,1,2,2.9450538214006837e-4,0
22119986,2,1,1,0.0013373380383133726,0
22149757,2,1,1,2.474604956902797e-4,0
2238623312,1,0,1,2.0060070574787447e-4,0
2252670684,6,3,3,3.3648836630787137e-4,0
2265403950,2,0,2,2.0060070574787447e-4,0
2268584392,4,2,2,0.002239931928702621,0
22708353,7,4,3,0.0013560457002194809,0.2857142857142857
2278893798,2,1,1,0.0013373380383133726,0
2280805769,7,6,1,0.001147185284597068,0.09523809523809523
229493956,3,1,2,2.9738550511039047e-4,0
230028736,7,6,1,5.37162763028182e-4,0.2380952380952381
23006472,2,1,1,3.157134351431413e-4,0
23018690,3,1,2,2.3093447893618224e-4,0.3333333333333333
2313784188,1,0,1,2.0060070574787447e-4,0
2328755451,6,1,5,2.446427619488431e-4,0
232957583,2,1,1,0.0013373380383123509,0
2341284950,12,11,1,0.0012020290059038376,0.2424242424242424
2341403496,1,0,1,2.0060070574787447e-4,0
234154003,4,3,1,0.0020746811729531016,0
2356812614,14,12,2,9.893130716867832e-4,0.42857142857142855
2364289039,2,0,2,2.0060070574787447e-4,0
236709875,5,2,3,8.029724490228926e-4,0
2383864146,5,0,5,2.0060070574787453e-4,0.2
2384097241,1,0,1,2.0060070574787447e-4,0
240095290,6,3,3,3.972006951632261e-4,0.13333333333333333
240356330,1,0,1,2.0060070574787447e-4,0
2414433138,18,2,16,3.109107858391952e-4,0.04575163398692811
2417849328,2,1,1,2.538203583388716e-4,0
242151754,24,9,15,7.125968499596796e-4,0.06884057971014493
2429886117,1,0,1,2.0060070574787447e-4,0
243135827,3,1,2,8.767718794247558e-4,0
2448527677,1,0,1,2.0060070574787447e-4,0
245639333,1,0,1,2.0060070574787447e-4,0
2467272554,2,1,1,0.0013373380383123509,0
2470000940,24,9,15,8.427282098428688e-4,0.21739130434782608
2476948563,2,1,1,2.833723853395375e-4,0
2478831440,1,0,1,2.0060070574787447e-4,0
24821879,2,1,1,3.056052111994966e-4,0
24823204,2,1,1,0.003496169642164562,0
24846824,2,0,2,2.0060070574787447e-4,0
2503547378,8,2,6,4.3901014937332056e-4,0.10714285714285714
251945720,3,1,2,2.4785945302249263e-4,0.3333333333333333
253585382,3,1,2,2.9268127603185025e-4,0
2538082935,2,1,1,2.2010361662985672e-4,0
2539632308,14,6,8,9.579815584291073e-4,0
2540056898,3,0,3,2.0060070574787447e-4,0
254279303,2,1,1,0.002658995152452007,0
2559005541,4,2,2,4.794793098706822e-4,0.16666666666666666
257644079,1,0,1,2.0060070574787447e-4,0
2591386356,1,0,1,2.0060070574787447e-4,0
2592488617,2,1,1,0.0013373380383123509,0
25949466,3,1,2,3.039509380129779e-4,0.3333333333333333
259703516,2,1,1,0.004187241039984232,0
260079722,3,2,1,3.135223548952527e-4,0
260087947,3,1,2,2.406682245520654e-4,0
2615972152,11,6,5,0.0012808718976555728,0.03636363636363636
2617786477,1,0,1,2.0060070574787447e-4,0
26254854,3,0,3,2.0060070574787447e-4,0.6666666666666666
2638771786,2,1,1,0.0013373380383133726,0
264085436,27,9,18,8.789898013423777e-4,0.15954415954415954
2645449265,2,1,1,0.002387330596617646,0
2646874996,3,2,1,0.0012411877035630324,0.3333333333333333
2664768119,9,4,5,0.0016638382892093552,0
2665222957,2,1,1,3.314282696196136e-4,0
266814956,1,0,1,2.0060070574787447e-4,0
2668541539,10,4,6,0.0010285410164642063,0
2670917924,1,0,1,2.0060070574787447e-4,0
26797907,9,5,4,6.714580561859567e-4,0.08333333333333333
269149617,3,2,1,4.299506956600399e-4,0
270698032,18,12,6,0.002691466064714677,0.13725490196078433
2742279203,13,7,6,0.0011172824105243138,0
274685249,1,0,1,2.0060070574787447e-4,0
2753375391,16,6,10,0.0013118746991847385,0.041666666666666664
2754243826,2,1,1,4.988698768911001e-4,0
2760035773,3,2,1,3.2948342841952315e-4,0.3333333333333333
2766988203,1,0,1,2.0060070574787447e-4,0
27738640,2,1,1,3.907783284496787e-4,0
2775908668,2,1,1,3.1946581288794696e-4,0
2780558549,15,4,11,0.0010597373403487275,0.009523809523809523
2781202710,6,4,2,9.219068163911451e-4,0
27854693,1,0,1,2.0060070574787447e-4,0
279998036,3,2,1,2.7191672058076284e-4,0
2806897927,6,3,3,0.002366146620122323,0.06666666666666667
281792077,1,0,1,2.0060070574787447e-4,0
2818030046,1,0,1,2.0060070574787447e-4,0
2823888746,2,1,1,5.08131768756906e-4,0
2841276346,4,2,2,3.394870868710523e-4,0
2864162535,3,2,1,5.620706965725235e-4,0
286442602,7,3,4,5.417069618600793e-4,0
2865340965,1,0,1,2.0060070574787447e-4,0
2873955731,8,6,2,9.083363235086562e-4,0.10714285714285714
2880037377,7,5,2,7.432456942772048e-4,0
2881586303,3,2,1,3.011430355526309e-4,0
2892991843,2,1,1,2.895929802335615e-4,1
2922112649,5,1,4,2.3093447893618224e-4,0
2922331025,12,7,5,0.0011730458642521104,0.15151515151515152
2965461610,4,1,3,4.0228276702671586e-4,0
298635447,2,0,2,2.0060070574787447e-4,0
30047971,4,2,2,2.8928308171477437e-4,0
30056683,4,0,4,2.0060070574787447e-4,0
30062488,3,2,1,5.603913515647157e-4,0
301209655,2,1,1,0.0013373380383133726,0
3024469779,5,2,3,3.0895845264453374e-4,0
303066485,2,0,2,2.0060070574787447e-4,0
3038412281,2,1,1,0.0013373380383123509,0
3058020040,3,2,1,3.528740188591261e-4,0
30609306,2,1,1,6.210258833422031e-4,0
308899953,2,1,1,0.0013373380383123509,0
30901808,2,1,1,2.972586660943562e-4,0
3096963855,3,1,2,2.932085648874694e-4,0
3114052794,13,12,1,0.0024969605280803168,0.14102564102564102
31146970,1,0,1,2.0060070574787447e-4,0
31163706,2,0,2,2.0060070574787447e-4,0
3135666467,2,0,2,2.0060070574787447e-4,0
313773946,3,1,2,2.0939358702514585e-4,0.3333333333333333
31570847,1,0,1,2.0060070574787447e-4,0
315891651,21,8,13,0.0010478792180741749,0.08571428571428572
3163266804,5,0,5,2.0060070574787453e-4,0
3183848149,6,1,5,2.8248950022882003e-4,0.06666666666666667
3195889007,2,1,1,6.320828812462301e-4,0
322131176,4,2,2,9.347740738721487e-4,0
322286421,4,2,2,7.71439589778186e-4,0
325870135,2,1,1,2.4386454377742562e-4,0
326051822,1,0,1,2.0060070574787447e-4,0
326796537,1,0,1,2.0060070574787447e-4,0
3268838984,10,4,6,7.178666709363315e-4,0.022222222222222223
3273862718,2,1,1,0.0013373380383123509,0
3284423738,1,0,1,2.0060070574787447e-4,0
3284784283,8,3,5,9.780600242905349e-4,0.03571428571428571
32885445,2,1,1,0.0013373380383123509,0
329029719,1,0,1,2.0060070574787447e-4,0
3293969369,1,0,1,2.0060070574787447e-4,0
3303696772,2,1,1,3.410671038223499e-4,0
3307318595,8,4,4,0.0022019498099789146,0
331146747,1,0,1,2.0060070574787447e-4,0
3318085586,2,1,1,3.579468625483695e-4,0
3332761755,3,1,2,3.5888238057175926e-4,0
333726113,3,1,2,3.7441007048683717e-4,0.3333333333333333
3339239405,4,2,2,0.0014950798191663082,0.16666666666666666
3344586328,1,0,1,2.0060070574787447e-4,0
334623243,14,2,12,3.2524940831538064e-4,0.010989010989010988
334660734,3,0,3,2.0060070574787447e-4,0.3333333333333333
3348565750,6,3,3,5.378015850541134e-4,0.06666666666666667
335484490,3,2,1,3.705462435985466e-4,0
336023926,4,2,2,0.0010515691865619784,0
3370477240,2,1,1,2.650711490055066e-4,0
3372411574,2,1,1,5.614668835972605e-4,0
3388780323,4,3,1,6.311448640814035e-4,0
339544187,14,5,9,5.730785735326347e-4,0.03296703296703297
3415077141,8,4,4,0.0011042755472174667,0.14285714285714285
3444110417,2,0,2,2.0060070574787447e-4,0
345181084,2,1,1,2.2191453073358615e-4,0
34609862,4,2,2,7.839438625269671e-4,0
349738807,3,1,2,3.104924609311142e-4,0.3333333333333333
351038866,5,0,5,2.0060070574787453e-4,0
35157947,2,1,1,0.0013373380383133726,0
35239985,1,0,1,2.0060070574787447e-4,0
3547970067,2,1,1,0.0013373380383123509,0
35573524,2,1,1,2.5085074314943484e-4,0
356267122,2,1,1,0.0013373380383133726,0
357603259,1,0,1,2.0060070574787447e-4,0
358613542,1,0,1,2.0060070574787447e-4,0
362342072,1,0,1,2.0060070574787447e-4,0
362418801,2,1,1,0.0013373380383123509,0
3627765012,5,2,3,4.850945350448046e-4,0
363710550,1,0,1,2.0060070574787447e-4,0
365837262,8,0,8,2.0060070574787447e-4,0.03571428571428571
366703037,2,1,1,0.0013373380383123509,0
3686828722,3,1,2,5.809961732013872e-4,0
376134587,1,0,1,2.0060070574787447e-4,0
378625573,6,3,3,4.2828998688204114e-4,0
380385797,5,1,4,3.3366562170143515e-4,0.1
381417800,1,0,1,2.0060070574787447e-4,0
3833297123,1,0,1,2.0060070574787447e-4,0
384636725,2,1,1,0.0013373380383133726,0
38729611,16,8,8,0.001408688864595415,0.11666666666666667
388726007,2,1,1,7.409644739941127e-4,0
3889164357,2,1,1,2.7266828745982667e-4,0
38944750,7,1,6,2.8343806068157414e-4,0.047619047619047616
390118453,1,0,1,2.0060070574787447e-4,0
391187727,3,2,1,4.299660449711962e-4,0
3929161,3,2,1,6.609642193629702e-4,0.3333333333333333
395349799,5,1,4,3.494382443271558e-4,0.2
398794375,2,1,1,4.8766927268101956e-4,0
404872138,1,0,1,2.0060070574787447e-4,0
40614474,3,2,1,4.7145484840848366e-4,0
406467105,7,4,3,4.0399514287230083e-4,0.09523809523809523
406654240,27,14,13,0.002356377135757874,0.10826210826210826
4071006503,10,7,3,0.0013092066863319744,0
407738637,1,0,1,2.0060070574787447e-4,0
409427707,1,0,1,2.0060070574787447e-4,0
41343510,1,0,1,2.0060070574787447e-4,0
414209774,2,0,2,2.0060070574787447e-4,1
414803551,4,1,3,2.4320856558337182e-4,0
415196848,1,0,1,2.0060070574787447e-4,0
416747967,1,0,1,2.0060070574787447e-4,0
417340229,2,1,1,3.1946581288794696e-4,0
420710798,23,3,20,6.750203496815301e-4,0.03557312252964427
4239143413,7,2,5,3.0917744397851974e-4,0.09523809523809523
425318685,2,1,1,0.0013373380383123509,0
432652724,2,1,1,6.093500724288669e-4,0
434370600,2,1,1,0.0013373380383123509,0
4351307654,1,0,1,2.0060070574787447e-4,0
435746974,1,0,1,2.0060070574787447e-4,0
4380328392,2,1,1,0.0013373380383123509,0
4386783615,2,1,1,0.0013373380383133726,0
440644496,1,0,1,2.0060070574787447e-4,0
447519445,1,0,1,2.0060070574787447e-4,0
44820343,38,11,27,0.0014480449664011094,0.07112375533428165
449268231,2,1,1,3.5064962512897465e-4,0
45048443,2,1,1,2.61490286988916e-4,0
4528248976,35,20,15,0.0029682222613938982,0.12436974789915967
460968098,12,5,7,4.8548769105061836e-4,0.10606060606060606
46624887,2,0,2,2.0060070574787447e-4,0
4666179488,5,4,1,0.002407606182811004,0
46770271,2,1,1,2.769284093253048e-4,0
468022281,15,8,7,0.0013015409820837168,0.1619047619047619
468185456,3,2,1,5.761592411398081e-4,0
469314544,9,8,1,6.141615842206517e-4,0.2222222222222222
47110856,4,0,4,2.0060070574787447e-4,0
47395300,7,3,4,5.083007418242784e-4,0.09523809523809523
47449365,2,1,1,3.391054740408057e-4,0
47527429,6,3,3,3.939732385920246e-4,0
476613553,1,0,1,2.0060070574787447e-4,0
478935878,1,0,1,2.0060070574787447e-4,0
4789548912,2,1,1,3.391054740408057e-4,0
480717665,2,1,1,4.7917232271743723e-4,0
4827890056,16,2,14,7.718083049357443e-4,0
484207932,3,1,2,2.2363920550354726e-4,0
48438207,6,2,4,6.927306655893912e-4,0.13333333333333333
485379264,1,0,1,2.0060070574787447e-4,0
4860829450,2,1,1,8.710089147810754e-4,0
4892348789,4,1,3,3.403467849528943e-4,0
491472688,1,0,1,2.0060070574787447e-4,0
49173812,1,0,1,2.0060070574787447e-4,0
494137810,2,1,1,3.5064962512897465e-4,0
495570762,2,1,1,2.650711490055066e-4,0
50394315,3,1,2,6.799123418988101e-4,0
508043072,8,2,6,3.952242422971979e-4,0.17857142857142858
509319582,6,3,3,4.932214560178764e-4,0
510805003,1,0,1,2.0060070574787447e-4,0
513559960,20,7,13,8.316474258712107e-4,0.12105263157894736
528983483,2,1,1,0.0013373380383123509,0
53143589,22,6,16,0.0012244454682901814,0.047619047619047616
538964597,17,8,9,9.016165876672146e-4,0.13970588235294118
539372253,6,3,3,4.6466393343188325e-4,0.06666666666666667
539882935,3,1,2,2.421899752791778e-4,0
548342907,13,6,7,0.0011046517701106206,0.1923076923076923
55449569,1,0,1,2.0060070574787447e-4,0
55465720,2,1,1,0.0013373380383123509,0
55585412,8,3,5,9.856820309437665e-4,0.07142857142857142
560892332,5,3,2,7.479475221187846e-4,0.1
570064029,2,1,1,6.799123418896557e-4,0
57039408,2,0,2,2.0060070574787447e-4,0
572098125,1,0,1,2.0060070574787447e-4,0
58007666,9,7,2,0.001351347366947516,0
58018875,1,0,1,2.0060070574787447e-4,0
581325683,5,3,2,6.584182893401639e-4,0.3
583358541,3,1,2,5.10170837313561e-4,0
589569762,1,0,1,2.0060070574787447e-4,0
594564076,4,2,2,2.7887343558239303e-4,0
596745491,4,3,1,6.970039731303441e-4,0.16666666666666666
617490873,4,2,2,3.251171502002434e-4,0
62108806,4,3,1,0.0012864472727713806,0
62690915,2,1,1,0.0013373380383123509,0
627476981,19,15,4,0.0012900367158098067,0.4269005847953216
632202921,3,2,1,8.251536893168689e-4,0.3333333333333333
66126700,5,3,2,8.16481227436213e-4,0.2
68319605,2,1,1,0.0014876534987012476,0
6.98614e+17,20,11,9,0.0017772184099758776,0.08947368421052632
7.00473e+17,2,1,1,3.057489090107187e-4,0
7.02604e+17,2,1,1,0.0013373380383123509,0
704708494,8,1,7,4.1382383742461453e-4,0
7.04778e+17,1,0,1,2.0060070574787447e-4,0
7.06661e+17,2,1,1,0.001964079702755759,0
7.0835e+17,9,3,6,0.001059168842695832,0
7.08704e+17,2,1,1,2.4254245644957562e-4,0
7.09746e+17,1,0,1,2.0060070574787447e-4,0
71315561,1,0,1,2.0060070574787447e-4,0
7.14813e+17,12,10,2,0.00275265606869608,0.0303030303030303
7.19557e+17,3,1,2,6.239694530739761e-4,0
72353726,1,0,1,2.0060070574787447e-4,0
723970656,5,2,3,3.8724893649805866e-4,0
7.24403e+17,2,1,1,0.0013373380383123509,0
7.25061e+17,1,0,1,2.0060070574787447e-4,0
7.26495e+17,1,0,1,2.0060070574787447e-4,0
7.31901e+17,5,0,5,2.0060070574787453e-4,0.3
7.33809e+17,6,3,3,5.148487253664976e-4,0
7.34434e+17,1,0,1,2.0060070574787447e-4,0
7.38293e+17,4,3,1,6.072172827576353e-4,0.16666666666666666
7.38551e+17,5,2,3,5.43969641034063e-4,0.1
73999352,2,1,1,0.0013373380383133726,0
7.4467e+17,10,3,7,5.547998316097853e-4,0
7.45705e+17,2,1,1,3.511924155827738e-4,0
7.46783e+17,2,1,1,0.0013373380383123509,0
7.50318e+17,3,1,2,2.832026261068399e-4,0.3333333333333333
7.52342e+17,2,1,1,0.0013373380383123509,0
758947081,3,1,2,5.016937083214637e-4,0
7.61528e+17,6,3,3,8.099235430440772e-4,0.13333333333333333
76281723,4,2,2,3.1377580159176255e-4,0.16666666666666666
7.66352e+17,2,0,2,2.0060070574787447e-4,0
7.6729e+17,8,2,6,3.682358098138298e-4,0.03571428571428571
767442764,2,1,1,6.875122734569803e-4,0
7.67931e+17,3,0,3,2.0060070574787447e-4,0
7.69619e+17,6,3,3,0.0010854037517971534,0.06666666666666667
7.71056e+17,3,2,1,4.0541971722627123e-4,0
7.74188e+17,2,1,1,4.2940483724607264e-4,0
7.75777e+17,1,0,1,2.0060070574787447e-4,0
77757185,5,3,2,4.6445926875197436e-4,0.1
7.80543e+17,20,12,8,0.001015575559496447,0.13157894736842105
78139709,2,1,1,3.7941801915132963e-4,0
7.81597e+17,9,5,4,9.490920530778335e-4,0
7.87954e+17,2,1,1,3.711113056335678e-4,0
78813002,1,0,1,2.0060070574787447e-4,0
7.88776e+17,2,1,1,0.0016321440589641212,0
7.8881e+17,3,1,2,5.809961732013872e-4,0
7.89691e+17,3,1,2,5.924111027141111e-4,0
7.91894e+17,2,1,1,5.454688750266415e-4,0
8.06605e+17,8,0,8,2.0060070574787447e-4,0
8.07258e+17,18,16,2,0.0023854338364510627,0.0065359477124183
8.08117e+17,2,1,1,2.688328261469241e-4,0
8.09244e+17,2,1,1,0.0013373380383123509,0
8.14137e+17,1,0,1,2.0060070574787447e-4,0
81671765,2,1,1,2.4134938766801067e-4,0
8.1723e+17,7,4,3,0.0016916881275915376,0
81836528,14,4,10,6.286495373687441e-4,0.09890109890109891
8.18713e+17,1,0,1,2.0060070574787447e-4,0
8.22229e+17,14,9,5,8.624561032318295e-4,0.14285714285714285
8.22486e+17,2,1,1,0.0019354736737497334,0
82257345,1,0,1,2.0060070574787447e-4,0
8.25754e+17,1,0,1,2.0060070574787447e-4,0
8.28043e+17,1,0,1,2.0060070574787447e-4,0
8.29722e+17,2,1,1,0.0023320732383165024,0
8.31395e+17,12,5,7,0.0011082357268253282,0.07575757575757576
8.35887e+17,2,1,1,0.0013373380383123509,0
8.39623e+17,1,0,1,2.0060070574787447e-4,0
8.39625e+17,2,1,1,0.0013373380383123509,0
8.4101e+17,3,2,1,0.0015141797564157333,0
842988756,3,2,1,3.8959196959043464e-4,0.3333333333333333
8.44115e+17,6,4,2,9.800044740713352e-4,0
8.45827e+17,6,3,3,0.0014838535679855434,0
8.46492e+17,2,1,1,4.475240793578252e-4,0
8483002,2,1,1,2.669071094754746e-4,0
8.48361e+17,2,1,1,4.0228276702691405e-4,0
8.49268e+17,12,6,6,0.002184997879344421,0.01515151515151515
8.49705e+17,4,1,3,4.888403586825593e-4,0
8.50003e+17,7,5,2,5.509922708095671e-4,0.047619047619047616
85564644,3,2,1,2.7209009334760645e-4,0
855952662,10,4,6,4.118279918111015e-4,0.044444444444444446
8.56961e+17,8,3,5,8.019197113758561e-4,0.17857142857142858
8.58651e+17,2,1,1,6.911966882260881e-4,0
859586149,2,0,2,2.0060070574787447e-4,0
8.61436e+17,5,3,2,5.227783709512116e-4,0
8.63048e+17,2,1,1,6.210258833422031e-4,0
8.6741e+17,2,1,1,2.5316771347578306e-4,0
8.70306e+17,9,3,6,0.0011642817851102588,0.027777777777777776
8.70744e+17,3,1,2,5.101420719882766e-4,0.3333333333333333
8.72828e+17,2,1,1,2.833723853395375e-4,0
8.72973e+17,4,2,2,8.479403608904665e-4,0
87472789,7,5,2,0.0012605708795334581,0.047619047619047616
87493194,2,1,1,0.0013373380383123509,0
8.7708e+17,1,0,1,2.0060070574787447e-4,0
8.82249e+17,5,2,3,7.191094797546557e-4,0
8.84118e+17,5,4,1,5.88938832384118e-4,0
8.84839e+17,2,0,2,2.0060070574787447e-4,0
8.87231e+17,2,1,1,2.334993373351463e-4,0
88744163,6,1,5,2.4618730654187005e-4,0
887829151,4,3,1,0.0022265984622083157,0
89101195,2,0,2,2.0060070574787447e-4,0
8.91237e+17,2,1,1,0.0013373380383133726,0
8.9124e+17,2,1,1,0.0013373380383123509,0
895329918,3,2,1,2.8312783609255005e-4,0
8.98477e+17,3,2,1,5.808106608406159e-4,0
8.98991e+17,2,1,1,0.0014328240245328637,0
9.00232e+17,6,1,5,3.1506599622835974e-4,0
9.00639e+17,2,0,2,2.0060070574787447e-4,0
9.00741e+17,10,5,5,0.0017997529881712006,0.022222222222222223
9.01059e+17,4,3,1,0.0038771399251961033,0
9.05111e+17,15,6,9,0.0010837308745564292,0.08571428571428572
90648099,1,0,1,2.0060070574787447e-4,0
9.08691e+17,52,17,35,0.0016498390095843318,0.08220211161387632
9.1043e+17,1,0,1,2.0060070574787447e-4,0
9.11959e+17,6,4,2,0.0015223483574200944,0
9.12074e+17,5,2,3,2.9371375479195536e-4,0
9.12747e+17,14,9,5,0.0014257668869395667,0.2087912087912088
9.13082e+17,5,0,5,2.0060070574787453e-4,0
9.13375e+17,4,3,1,0.0014128048416745247,0.16666666666666666
9.13946e+17,10,2,8,4.1741121352578827e-4,0.08888888888888889
9.14248e+17,6,3,3,5.870889244005656e-4,0
9.14442e+17,5,1,4,3.023862463307327e-4,0
91473252,16,8,8,0.001385993322917278,0.15833333333333333
9.14761e+17,2,1,1,5.726825392058733e-4,0
9.16439e+17,6,2,4,5.087956744905321e-4,0
9.17505e+17,8,3,5,3.4063421278122876e-4,0.10714285714285714
9.17969e+17,3,1,2,2.4254245644957562e-4,0
91877344,3,2,1,6.539638147984627e-4,0
9.20659e+17,13,4,9,8.764060192061815e-4,0.025641025641025644
9.21785e+17,4,2,2,4.225884855871547e-4,0
9.22477e+17,3,0,3,2.0060070574787447e-4,0
9.24158e+17,1,0,1,2.0060070574787447e-4,0
9.26443e+17,45,24,21,0.002386817606853864,0.1313131313131313
9.28888e+17,3,2,1,2.6204536733155117e-4,0
9.30238e+17,15,10,5,0.0021603346308634815,0.028571428571428574
9.31954e+17,7,4,3,9.453485669541282e-4,0
9.32126e+17,4,2,2,9.96161758417194e-4,0
9.32935e+17,6,4,2,7.80878073009761e-4,0.06666666666666667
9.33191e+17,1,0,1,2.0060070574787447e-4,0
9.33476e+17,4,0,4,2.0060070574787447e-4,0.16666666666666666
9.34871e+17,12,5,7,8.044161813991575e-4,0.01515151515151515
9.35265e+17,18,6,12,0.0010174246829923025,0.0522875816993464
9.35608e+17,1,0,1,2.0060070574787447e-4,0
9.36953e+17,1,0,1,2.0060070574787447e-4,0
9.37753e+17,8,7,1,0.0021400556562607195,0.03571428571428571
9.40169e+17,6,4,2,6.550778736437566e-4,0
9.40836e+17,3,1,2,2.5472479324817885e-4,0
9.42184e+17,19,13,6,0.001784687838536664,0.16959064327485382
9.42842e+17,2,0,2,2.0060070574787447e-4,0
9.43124e+17,4,2,2,0.002189198845575338,0
9.43544e+17,11,4,7,4.734730138803767e-4,0
9.44279e+17,5,1,4,2.952698119328592e-4,0
9.4448e+17,3,2,1,6.947073466128826e-4,0.3333333333333333
9.44593e+17,41,17,24,0.001820341927278524,0.07195121951219512
9.44837e+17,11,4,7,7.805461398376912e-4,0.09090909090909091
9.45397e+17,11,5,6,8.855695555569637e-4,0.09090909090909091
9.45486e+17,31,11,20,0.0010887928312528347,0.08602150537634408
9.45689e+17,3,1,2,5.590333012199497e-4,0
9.46038e+17,3,2,1,0.0012263525352343824,0
9.4608e+17,3,2,1,3.0729697290411006e-4,0
9.46112e+17,4,0,4,2.0060070574787447e-4,0
9.46448e+17,2,1,1,2.691615404620401e-4,0
9.46482e+17,3,2,1,3.1833184793752465e-4,0
9.46627e+17,8,3,5,5.238829744512214e-4,0.03571428571428571
9.46846e+17,8,4,4,0.001114818917553121,0
9.47159e+17,7,3,4,0.0012563425833840708,0
9.47437e+17,3,1,2,8.433708128754712e-4,0
9.47465e+17,2,1,1,2.586687163325836e-4,0
9.47532e+17,8,3,5,6.271777684701188e-4,0.14285714285714285
9.48081e+17,5,2,3,0.0011964424309826767,0.1
9.48194e+17,3,1,2,2.3528442745720667e-4,0
9.48281e+17,3,2,1,0.0017330252807820936,0
9.48285e+17,6,4,2,7.943046792416002e-4,0.33333333333333337
9.48524e+17,4,2,2,4.5646679796549917e-4,0
9.48933e+17,1,0,1,2.0060070574787447e-4,0
9.49012e+17,9,1,8,3.096341796449657e-4,0
9.4902e+17,1,0,1,2.0060070574787447e-4,0
9.49051e+17,7,4,3,6.139097098296312e-4,0.2857142857142857
9.49086e+17,27,16,11,0.0017883169680281861,0.11396011396011395
9.49146e+17,2,1,1,4.675735047166395e-4,0
9.49188e+17,9,6,3,9.927271409613714e-4,0.08333333333333333
9.49244e+17,5,4,1,8.773832454749161e-4,0.2
9.50442e+17,7,3,4,5.079111647051249e-4,0.047619047619047616
9.50495e+17,7,2,5,5.447521125858526e-4,0
9.51376e+17,8,4,4,0.0012072910405087965,0
9.51483e+17,5,4,1,4.288266950111674e-4,0
9.51877e+17,9,3,6,5.870615766005114e-4,0
9.52558e+17,6,4,2,5.721684615007262e-4,0
9.52595e+17,8,3,5,0.0010984569956009882,0.03571428571428571
9.54837e+17,31,17,14,0.0013166692309362368,0.16344086021505377
9.55295e+17,2,1,1,5.609753591257632e-4,0
9.58442e+17,3,2,1,0.0016788897597348822,0
9592092,4,1,3,3.843246290448563e-4,0.3333333333333333
9.59437e+17,1,0,1,2.0060070574787447e-4,0
9.59608e+17,22,5,17,6.066754637661552e-4,0.030303030303030304
9.61038e+17,8,3,5,6.413733758652425e-4,0
9.6145e+17,8,3,5,5.693223491916737e-4,0
9.62035e+17,2,1,1,4.4648667613149433e-4,0
9.63254e+17,8,2,6,3.2328562796233164e-4,0.10714285714285714
9.63674e+17,7,1,6,3.1088510259507247e-4,0
9.64516e+17,4,2,2,3.237439761040391e-4,0
9.64652e+17,19,10,9,0.0010027446165870682,0.05847953216374269
9.652e+17,4,2,2,9.320806401081947e-4,0
9.65454e+17,1,0,1,2.0060070574787447e-4,0
9.65865e+17,7,3,4,0.001209263556859014,0
9.67143e+17,4,1,3,2.3865489286303644e-4,0
9.69079e+17,10,4,6,9.510119795397404e-4,0.022222222222222223
9.69616e+17,5,2,3,5.38966620525217e-4,0
9.71137e+17,3,2,1,2.663773119579951e-4,0
9.71653e+17,11,5,6,0.0010083639715206946,0.03636363636363636
9.71729e+17,7,5,2,0.002259793305745413,0.047619047619047616
9.73588e+17,11,4,7,8.191184761902353e-4,0.2363636363636364
9.73748e+17,1,0,1,2.0060070574787447e-4,0
9.75968e+17,2,1,1,2.7715389832132757e-4,0
9.77847e+17,1,0,1,2.0060070574787447e-4,0
9.78128e+17,11,6,5,0.0012036777704307938,0.09090909090909091
9.78167e+17,2,1,1,3.391054740412663e-4,0
9.78242e+17,9,4,5,5.888390566345538e-4,0.16666666666666666
9.7898e+17,8,5,3,0.0012796521054569685,0.21428571428571427
9.79251e+17,2,1,1,6.250628267442595e-4,0
9.79732e+17,2,1,1,2.290191390621567e-4,0
9.80096e+17,3,2,1,7.954954984433898e-4,0
9.8126e+17,5,2,3,0.0010449297212554427,0
9.82214e+17,5,3,2,4.410765483100656e-4,0
9.86306e+17,1,0,1,2.0060070574787447e-4,0
9.86956e+17,2,1,1,0.0013373380383123509,0
9.87098e+17,2,1,1,2.601977814510877e-4,0
9.88509e+17,4,3,1,0.0020410270211786577,0
9.88993e+17,4,3,1,9.527747466347287e-4,0
9.91238e+17,2,1,1,3.081703459508967e-4,0
9.92498e+17,6,5,1,0.0032893603107496993,0.06666666666666667
9.92535e+17,4,2,2,4.355821226406137e-4,0
9.93041e+17,2,1,1,2.4386454377742562e-4,0
9.93045e+17,4,1,3,3.1571343514307524e-4,0
9.94443e+17,2,1,1,0.0013373380383123509,0
9.94787e+17,2,1,1,0.0013373380383123509,0
9.97327e+17,2,1,1,3.291171681525345e-4,0
9.97596e+17,5,4,1,5.525782136626687e-4,0.3
9.98985e+17,10,4,6,5.014495900763279e-4,0.08888888888888889
9.99469e+17,3,2,1,4.956233986955221e-4,0
2946171664,1,1,0,3.711113056335678e-4,0
1.37323e+18,4,4,0,6.025401234379284e-4,0.16666666666666666
8.53836e+17,4,4,0,5.930213177759284e-4,0.6666666666666666
1.03971e+18,1,1,0,5.38274125423522e-4,0
1.346e+18,6,6,0,0.0011319530570040384,0
426277984,11,11,0,0.0012653301314280256,0.01818181818181818
7.04793e+17,1,1,0,2.650715227549521e-4,0
1.26107e+18,5,5,0,0.0012076810235958622,0.3
34596198,1,1,0,2.643852386167918e-4,0
9.95698e+17,4,4,0,7.60356450448208e-4,0
1.29893e+18,2,2,0,3.7644133170984843e-4,0
9.82014e+17,1,1,0,2.979121817888668e-4,0
437819112,1,1,0,2.8585600569072114e-4,0
1.10645e+18,1,1,0,2.8585600569072114e-4,0
7.96335e+17,2,2,0,6.861196281043929e-4,0
1.37042e+18,3,3,0,6.981330932277945e-4,0
8.1816e+17,1,1,0,3.486759648661264e-4,0
1.1866e+18,6,6,0,0.0012195568415711798,0.33333333333333337
9.99181e+17,6,6,0,0.001050759928441883,0.13333333333333333
1.32795e+18,1,1,0,2.942946062532968e-4,0
9.04612e+17,4,4,0,6.464190083413957e-4,0.3333333333333333
2939933507,2,2,0,4.052134256107064e-4,0
1.28962e+18,1,1,0,4.1471701794890207e-4,0
266260135,1,1,0,3.711113056335678e-4,0
9.01266e+17,2,2,0,4.1797109557609516e-4,0
8.38073e+17,3,3,0,8.99495487693032e-4,0
1.09302e+18,1,1,0,4.2858735899808237e-4,0
1.37941e+18,23,23,0,0.003993689308765269,0.011857707509881422
1.30508e+18,2,2,0,3.521305043551604e-4,0
1.22471e+18,3,3,0,4.7191731914077666e-4,0.6666666666666666
8.38077e+17,1,1,0,2.672486595670072e-4,0
184954346,1,1,0,3.291171681527263e-4,0
3023360911,3,3,0,4.4409607332283896e-4,0
1.29395e+18,8,8,0,0.0010970237995557035,0
9.61817e+17,3,3,0,6.693257253163324e-4,0
1.24244e+18,6,6,0,7.726759122317257e-4,0
1.36161e+18,6,6,0,9.18268206160279e-4,0
1.05069e+18,2,2,0,4.137389556049911e-4,0
1.21608e+18,2,2,0,3.1178274429848973e-4,0
942617634,1,1,0,2.3865489286303647e-4,0
7.27078e+17,1,1,0,2.3865489286303647e-4,0
9.8984e+17,2,2,0,4.091654927487298e-4,0
3059706638,2,2,0,2.7463521578998285e-4,0
7.82602e+17,3,3,0,3.817066188096853e-4,0.3333333333333333
2248313230,3,3,0,6.88691422504004e-4,0.3333333333333333
271911263,2,2,0,2.827656969918435e-4,0
1.21304e+18,5,5,0,0.0010128304234622142,0
1.17646e+18,2,2,0,3.0429736231896626e-4,0
312636941,1,1,0,2.574375723764389e-4,0
217425933,1,1,0,2.574375723764389e-4,0
9.51495e+17,7,7,0,6.854182585265216e-4,0.2380952380952381
2263137086,2,2,0,3.87628441131275e-4,0
1.31206e+18,5,5,0,0.0010236590892197489,0.2
110605827,3,3,0,7.695415589702175e-4,0
7.59051e+17,2,2,0,6.366055181101742e-4,0
2337724718,8,8,0,0.0010351646362048617,0.10714285714285714
1.27066e+18,5,5,0,0.0018671785516754184,0.1
1.27329e+18,4,4,0,0.0010140067123556782,0.16666666666666666
2227519243,5,5,0,0.0010200395798375971,0
42567817,1,1,0,2.432283557192978e-4,0
9.39307e+17,5,5,0,6.187798815826573e-4,0
1.03566e+18,3,3,0,0.0012548378491706973,0
4744548854,4,4,0,6.725486312012823e-4,0.16666666666666666
43301547,5,5,0,5.11157425000792e-4,0.1
9.63976e+17,2,2,0,4.073084687159868e-4,0
9.25002e+17,3,3,0,5.011000581949929e-4,0.3333333333333333
1.20347e+18,4,4,0,0.0010383609593159228,0.16666666666666666
335943125,1,1,0,6.867151552562422e-4,0
51809476,3,3,0,9.361216865595844e-4,0
1.06483e+18,1,1,0,3.711113056335678e-4,0
1.1402e+18,5,5,0,6.464231629275304e-4,0.4
8.77408e+17,1,1,0,3.8268900521434634e-4,0
1.29566e+18,3,3,0,5.210910897703469e-4,0.3333333333333333
500399906,1,1,0,3.711113056335678e-4,0
70183578,4,4,0,0.0010496408728903441,0
1.29774e+18,1,1,0,4.925351338708515e-4,0
7.35966e+17,2,2,0,4.2723243827290293e-4,0
1.26463e+18,2,2,0,4.337061796486299e-4,0
1.35997e+18,1,1,0,2.945634568809319e-4,0
443073989,2,2,0,4.3088980781482746e-4,1
730481172,1,1,0,2.945634568809319e-4,0
1.34649e+18,7,7,0,7.499412739091904e-4,0.14285714285714285
2270959364,5,5,0,7.835308318507036e-4,0.2
578380018,2,2,0,4.563666055764144e-4,0
1.17761e+18,3,3,0,3.5513331695301417e-4,0
17002351,3,3,0,6.286404940572544e-4,0
9.41994e+17,5,5,0,7.814448106015046e-4,0.4
1.1886e+18,5,5,0,8.449281098178906e-4,0.1
508182536,1,1,0,2.7103083773565104e-4,0
1.05532e+18,2,2,0,3.723129447173739e-4,0
9.8832e+17,3,3,0,3.469691236153742e-4,0
1.37745e+18,9,9,0,0.0010062779391816895,0.2222222222222222
8.57404e+17,1,1,0,2.771538983213507e-4,0
1.25108e+18,5,5,0,7.628704852253708e-4,0.1
4898301,1,1,0,2.9684620072523745e-4,0
9.30041e+17,1,1,0,2.8585600569072114e-4,0
415671881,1,1,0,3.223935773528402e-4,0
900265802,5,5,0,6.625139489682679e-4,0
1.13483e+18,2,2,0,3.7662189524560177e-4,0
1080996930,1,1,0,2.7354135125453216e-4,0
77380160,2,2,0,4.440519511402255e-4,0
1.31836e+18,1,1,0,3.164506547729476e-4,0
1076938928,1,1,0,3.711113056335678e-4,0
1.12839e+18,6,6,0,6.883978639049393e-4,0.26666666666666666
1.1546e+18,2,2,0,4.279481722621322e-4,0
7.6654e+17,1,1,0,2.982790798968811e-4,0
431831209,1,1,0,3.711113056335678e-4,0
271537125,1,1,0,2.738882832523383e-4,0
122310026,1,1,0,2.738882832523383e-4,0
1.10395e+18,1,1,0,2.601977814510877e-4,0
46737288,1,1,0,2.8585600569072114e-4,0
1.37122e+18,2,2,0,4.563666055764144e-4,0
1.31784e+18,2,2,0,4.563666055764144e-4,0
1.1954e+18,2,2,0,3.688050385771025e-4,0
120111839,2,2,0,3.3998009319102546e-4,0
1.01843e+18,1,1,0,3.2912532093512704e-4,0
9.51666e+17,2,2,0,3.3763352413247456e-4,0
1.36894e+18,1,1,0,3.711113056335678e-4,0
1.3648e+18,1,1,0,3.194658128880456e-4,0
1.27083e+18,2,2,0,5.729114071805256e-4,0
1.37268e+18,4,4,0,7.845995103563741e-4,0
1.26266e+18,3,3,0,5.384478084571418e-4,0
1.11295e+18,1,1,0,2.4386454377743722e-4,0
7.76437e+17,1,1,0,2.4386454377743722e-4,0
4881139042,2,2,0,2.6690304353311e-4,0
2227436731,2,2,0,2.846132256977065e-4,0
7.30114e+17,1,1,0,2.4386454377743722e-4,0
124996190,1,1,0,2.4386454377743722e-4,0
589054850,1,1,0,2.4386454377743722e-4,0
17228521,1,1,0,2.4386454377743722e-4,0
1.11543e+18,1,1,0,2.4386454377743722e-4,0
7.19909e+17,1,1,0,2.4386454377743722e-4,0
1.18874e+18,1,1,0,2.4386454377743722e-4,0
1.19378e+18,1,1,0,2.4386454377743722e-4,0
71819987,2,2,0,4.143751436631306e-4,0
978776468,3,3,0,4.217277028598788e-4,0
578841971,1,1,0,2.4386454377743722e-4,0
8.92376e+17,4,4,0,6.363476365500455e-4,0.16666666666666666
1.35697e+18,1,1,0,3.711113056335678e-4,0
1.32391e+18,1,1,0,3.314359152366594e-4,0
4777383375,4,4,0,8.643626476547122e-4,0.3333333333333333
755890603,4,4,0,6.827637579888008e-4,0
1.33313e+18,4,4,0,9.96935632526333e-4,0
1.32621e+18,3,3,0,6.079757020663064e-4,0.3333333333333333
1.21328e+18,2,2,0,4.065394924855191e-4,0
1.2559e+18,2,2,0,5.141818962180236e-4,0
8.62801e+17,2,2,0,3.1919163459663503e-4,0
1.37172e+18,2,2,0,3.8129271224988026e-4,0
1.37578e+18,3,3,0,4.212361889311893e-4,0
438997939,2,2,0,3.1919163459663503e-4,0
1.30771e+18,2,2,0,3.2575548606397336e-4,0
1482611202,1,1,0,2.8585600569072114e-4,0
128104826,1,1,0,2.8585600569072114e-4,0
1.30541e+18,1,1,0,2.447115098766815e-4,0
161590330,2,2,0,4.1522210976237484e-4,0
2924439129,1,1,0,2.8585600569072114e-4,0
852267594,1,1,0,2.352844274572139e-4,0
1.17945e+18,3,3,0,3.0927174890516495e-4,0
175096743,1,1,0,2.3256016900480048e-4,0
1.34791e+18,2,2,0,2.9515504301986264e-4,1
1.289e+18,2,2,0,2.7941995894732784e-4,0
1.15985e+18,1,1,0,3.583230106421408e-4,0
9.42133e+17,1,1,0,2.315251892425644e-4,0
8.8674e+17,3,3,0,3.6166901584924277e-4,0
262905402,1,1,0,2.315251892425644e-4,0
36172970,1,1,0,2.315251892425644e-4,0
193990081,2,2,0,2.264446470137152e-4,0
1.36613e+18,1,1,0,2.176517657364438e-4,0
1.34167e+18,1,1,0,2.176517657364438e-4,0
1.37002e+18,4,4,0,3.3693432916207547e-4,0.3333333333333333
1.36661e+18,2,2,0,3.881623656221371e-4,0
149968455,1,1,0,2.176517657364438e-4,0
1.09926e+18,2,2,0,2.882091776106711e-4,0
392884670,2,2,0,5.195666665895022e-4,0
702303373,3,3,0,2.9846796646090405e-4,0
1.13485e+18,2,2,0,5.567939974566764e-4,0
49515709,1,1,0,2.4134938766814378e-4,0
502600440,3,3,0,5.719749805803446e-4,0
1.12968e+18,3,3,0,4.7403523440212107e-4,0
176578819,1,1,0,2.4320856558343682e-4,0
1.27496e+18,4,4,0,4.4888183028568996e-4,0.16666666666666666
2400106946,1,1,0,2.176517657364438e-4,0
8.04462e+17,1,1,0,2.176517657364438e-4,0
607862740,1,1,0,2.176517657364438e-4,0
143761507,1,1,0,2.176517657364438e-4,0
1.03944e+18,2,2,0,2.835385149978414e-4,0
8.27135e+17,1,1,0,3.711113056335678e-4,0
1.04564e+18,1,1,0,2.586687163325836e-4,0
8.84793e+17,1,1,0,2.586687163325836e-4,0
363122568,2,2,0,3.176574604796353e-4,0
2985086508,1,1,0,2.3658102867482088e-4,0
1.35083e+18,1,1,0,3.8254727142722787e-4,0
1.25263e+18,1,1,0,3.057489090107187e-4,0
2658827755,1,1,0,3.057489090107187e-4,0
1.36349e+18,3,3,0,5.459056605449698e-4,0.3333333333333333
1206041426,3,3,0,3.215605115472782e-4,0.3333333333333333
8.0119e+17,1,1,0,3.711113056335678e-4,0
169082573,3,3,0,9.422290330686441e-4,0.6666666666666666
8.6169e+17,1,1,0,3.391054740411646e-4,0
1217433457,1,1,0,3.391054740411646e-4,0
1.37692e+18,2,2,0,5.071120573108789e-4,0
67048579,2,2,0,3.8251278003409005e-4,0
2501567072,1,1,0,2.8585600569072114e-4,0
1068355627,5,5,0,6.990732990347388e-4,0.1
3111836591,1,1,0,3.711113056335678e-4,0
1.00134e+18,2,2,0,8.606608613906849e-4,0
1.34448e+18,3,3,0,5.469133318800038e-4,0.3333333333333333
1.29317e+18,1,1,0,3.711113056335678e-4,0
1.35274e+18,4,4,0,0.0011807866913257465,0
1.27525e+18,1,1,0,2.832024825672209e-4,0
1.34859e+18,1,1,0,2.8585600569072114e-4,0
9.99588e+17,6,6,0,8.835708419480262e-4,0.5333333333333333
1.27267e+18,1,1,0,2.290191390621567e-4,0
254341951,1,1,0,2.290191390621567e-4,0
1.23206e+18,1,1,0,2.199233536239806e-4,0
1.36148e+18,1,1,0,2.8585600569072114e-4,0
1.37198e+18,1,1,0,2.8585600569072114e-4,0
511797386,2,2,0,5.57889709681183e-4,0
39361135,1,1,0,2.4785945302261943e-4,0
89038787,1,1,0,5.692472036806635e-4,0
535241898,1,1,0,5.16045315536407e-4,0
4213135953,1,1,0,2.542737145059558e-4,0
1.36657e+18,3,3,0,3.854558574880013e-4,0
534790879,1,1,0,2.3741188417289149e-4,0
564219600,1,1,0,3.583230106421408e-4,0
1.31534e+18,2,2,0,4.435783105849875e-4,0
57267042,1,1,0,4.0403537585454407e-4,0
9.61028e+17,1,1,0,2.7261325119477066e-4,0
8.77918e+17,1,1,0,3.711113056335678e-4,0
1.33634e+18,2,2,0,4.1669790642767684e-4,0
1.3237e+18,2,2,0,3.000652223478622e-4,0
3070507997,1,1,0,2.574375723764389e-4,0
1.35207e+18,1,1,0,3.711113056335678e-4,0
50338197,1,1,0,3.711113056335678e-4,0
1.15366e+18,1,1,0,5.730620856992746e-4,0
28670204,2,2,0,4.6437226660302314e-4,0
7.53629e+17,1,1,0,2.443061689240676e-4,0
7.63649e+17,1,1,0,4.07366225030469e-4,0
9.98808e+17,1,1,0,3.711113056335678e-4,0
20554600,1,1,0,2.3177407183773237e-4,0
14897758,1,1,0,2.3177407183773237e-4,0
1.37217e+18,1,1,0,3.711113056335678e-4,0
1463015624,1,1,0,6.739231761875663e-4,0
1.36864e+18,2,2,0,5.284574624340977e-4,0
19669153,1,1,0,2.6319557976293664e-4,0
32384129,2,2,0,6.762710873438924e-4,0
1359688184,1,1,0,3.711113056335678e-4,0
12339652,1,1,0,3.3142826961967607e-4,0
115907231,1,1,0,3.3142826961967607e-4,0
1.24894e+18,3,3,0,3.726571566983656e-4,0
1.00218e+18,3,3,0,4.1936164126331246e-4,0
1.12678e+18,3,3,0,6.63558056764953e-4,0
7.48526e+17,1,1,0,2.9791218178885817e-4,0
9.43977e+17,2,2,0,2.635386858767995e-4,0
1.27742e+18,1,1,0,3.711113056335678e-4,0
3298454376,4,4,0,3.64488745614711e-4,0.3333333333333333
27928735,1,1,0,5.864907837922541e-4,0
2815149604,1,1,0,3.164533242689175e-4,0
8.90021e+17,1,1,0,3.164533242689175e-4,0
2241788852,2,2,0,6.37619027286624e-4,0
2386492158,2,2,0,6.191946414284766e-4,0
1.35497e+18,2,2,0,2.848613046682024e-4,0
87328334,2,2,0,4.563666055764144e-4,0
1.29577e+18,1,1,0,3.711113056335678e-4,0
17367764,1,1,0,3.711113056335678e-4,0
398622156,1,1,0,3.711113056335678e-4,0
19675541,1,1,0,2.9593907620177135e-4,0
9.66265e+17,4,4,0,7.296842237633673e-4,0
1.22221e+18,3,3,0,7.63769667715583e-4,0
1346206429,1,1,0,2.421899752791778e-4,0
9.85385e+17,1,1,0,4.2810956630436075e-4,0
1.00564e+18,1,1,0,3.711113056335678e-4,0
1241170872,1,1,0,3.711113056335678e-4,0
317992307,1,1,0,2.1711784124558173e-4,0
22800002,1,1,0,2.4098119391225632e-4,0
52039307,1,1,0,2.4098119391225632e-4,0
138245983,1,1,0,2.8585600569072114e-4,0
8.45195e+17,1,1,0,2.627938102424282e-4,0
9.4563e+17,1,1,0,3.023862463309671e-4,0
1.35829e+18,1,1,0,2.574375723764389e-4,0
7.64563e+17,2,2,0,4.279481722621322e-4,0
8.00433e+17,1,1,0,2.8248950022936707e-4,0
1.36612e+18,1,1,0,3.711113056335678e-4,0
1.32336e+18,1,1,0,4.3172991824152286e-4,0
15115218,1,1,0,3.711113056335678e-4,0
104690576,2,2,0,5.620667266097955e-4,0
1.17228e+18,3,3,0,6.210023133749354e-4,0.3333333333333333
228878983,1,1,0,2.496742825218132e-4,0
1.29249e+18,2,2,0,5.705291025564266e-4,0
3623915954,1,1,0,3.235460154766536e-4,0
1.13799e+18,1,1,0,2.432283557192978e-4,0
3419788504,1,1,0,3.25214345825049e-4,0
411661117,1,1,0,3.711113056335678e-4,0
381159353,1,1,0,3.711113056335678e-4,0
67123562,1,1,0,6.685150403683939e-4,0
19216818,1,1,0,2.2363920550354726e-4,0
1.03596e+18,2,2,0,3.326726794006385e-4,0
300735360,1,1,0,5.337768473218355e-4,0
9.34097e+17,1,1,0,2.3470282572501315e-4,0
1536594337,2,2,0,2.6198204953777705e-4,0
1.19015e+18,1,1,0,4.47524079358464e-4,0
245091513,2,2,0,0.0012545638115027992,0
295272896,3,3,0,6.461632320824875e-4,0.3333333333333333
1.36517e+18,1,1,0,3.711113056335678e-4,0
1.27321e+18,1,1,0,3.711113056335678e-4,0
1.21303e+18,1,1,0,3.711113056335678e-4,0
1.33772e+18,1,1,0,2.292890706093395e-4,0
60316183,1,1,0,2.292890706093395e-4,0
1.24147e+18,2,2,0,2.935461479546202e-4,0
9.45379e+17,1,1,0,2.292890706093395e-4,0
545442771,1,1,0,2.4618730654198345e-4,0
1.10838e+18,1,1,0,2.8585600569072114e-4,0
2220175646,1,1,0,3.711113056335678e-4,0
2443257276,1,1,0,2.4746049569040183e-4,0
350703561,1,1,0,2.4746049569040183e-4,0
50879493,1,1,0,2.4746049569040183e-4,0
2312796378,1,1,0,2.4746049569040183e-4,0
30977026,2,2,0,0.0013891275499425555,0
1463008550,1,1,0,2.970322948178612e-4,0
233282973,1,1,0,3.711113056335678e-4,0
485248169,1,1,0,2.8575338347200033e-4,0
1.24458e+18,1,1,0,2.8585600569072114e-4,0
1314952094,2,2,0,8.548639685788404e-4,0
1.34769e+18,1,1,0,7.93054082908667e-4,0
4001539815,1,1,0,4.6048727840698533e-4,0
964372705,1,1,0,2.5085074314943484e-4,0
18190227,1,1,0,3.50649625129784e-4,0
313371249,1,1,0,3.50649625129784e-4,0
2541880202,1,1,0,3.50649625129784e-4,0
2817123964,1,1,0,3.711113056335678e-4,0
17019970,1,1,0,3.711113056335678e-4,0
9.49231e+17,2,2,0,4.19354711652749e-4,0
14570995,1,1,0,3.711113056335678e-4,0
1.36969e+18,2,2,0,3.468897123336436e-4,0
221241777,1,1,0,4.0228276702691405e-4,0
1.13058e+18,1,1,0,4.47524079358464e-4,0
7.82976e+17,2,2,0,6.735435386347962e-4,0
189901822,1,1,0,2.2191453073358615e-4,0
7.14491e+17,1,1,0,0.001214410086239576,0
487437535,1,1,0,4.2910860797275996e-4,0
1.28184e+18,2,2,0,4.563666055764144e-4,0
2853639688,1,1,0,3.711113056335678e-4,0
1.0246e+18,3,3,0,7.212220118938019e-4,0
9.51702e+17,1,1,0,3.711113056335678e-4,0
1.144e+18,1,1,0,4.3187728509334e-4,0
1.01536e+18,2,2,0,3.164361562732548e-4,0
8.72466e+17,1,1,0,3.711113056335678e-4,0
1.25884e+18,1,1,0,4.043483916783603e-4,0
14357093,1,1,0,3.087197865771125e-4,0
1.18051e+18,1,1,0,2.585085219206834e-4,0
1.00995e+18,1,1,0,4.6844946638487745e-4,0
1.28105e+18,1,1,0,2.726682874598292e-4,0
39815093,1,1,0,2.580938574333488e-4,0
8.96952e+17,1,1,0,2.580938574333488e-4,0
21593576,1,1,0,2.633455407836071e-4,0
26274851,1,1,0,2.633455407836071e-4,0
2795504851,1,1,0,7.911019503688248e-4,0
253806022,1,1,0,2.6507114900565555e-4,0
7.81189e+17,1,1,0,2.9538130844245126e-4,0
1.09604e+18,1,1,0,2.432283557192978e-4,0
9.44514e+17,1,1,0,4.6757350471698955e-4,0
9.34806e+17,1,1,0,4.204691146305706e-4,0
497665213,1,1,0,3.072209263877947e-4,0
9.25896e+17,1,1,0,5.395927278596329e-4,0
1.32338e+18,1,1,0,3.945990948832116e-4,0
66697054,1,1,0,3.711113056335678e-4,0
382466573,1,1,0,2.334993373351521e-4,0
1.05466e+18,1,1,0,2.334993373351521e-4,0
1.20774e+18,1,1,0,4.571500518559937e-4,0
1271355828,2,2,0,3.548064543604267e-4,0
448589470,1,1,0,2.8376776243294695e-4,0
1.26575e+18,1,1,0,4.437723018856831e-4,0
64734256,2,2,0,7.160909846558065e-4,0
44535512,1,1,0,3.3819189559209105e-4,0
2285457534,1,1,0,5.967349777938572e-4,0
3299803690,1,1,0,3.5330791489668594e-4,0
4277450819,1,1,0,3.711113056335678e-4,0
1.2403e+18,1,1,0,3.711113056335678e-4,0
